NO ./textures/library_NO.xpm
SO ./textures/library_SO.xpm
WE ./textures/library_WE.xpm
EA ./textures/library_EA.xpm

F 120,100,60
C 170,150,110

111111111111111
100000000000001
101111101111101
100000000000001
101111101111101
10000000000001
101111101111101
100000000000001
101111101111101
100000000000001
111111111111111
