      NO       ./textures/42_NO.xpm
SO ./textures/42_SO.xpm
     WE ./textures/42_WE.xpm
EA ./textures/42_EA.xpm

F    82,7,14
C 145,182,227

111111111111111
100000000000001
100000000000001
100000000000001
100000000000001
101000101111101
101000100000101
101111101111101
100000101000001
100000101111101
10000E000000001
100000000000001
100000000000001
100000000000001
111111111111111
