C 055,055,055
F 0,0,0

WE ./textures/noite160.xpm
EA ./textures/fundo160.xpm
NO ./textures/corredor160.xpm
SO ./textures/tapete160.xpm


        11111111
        1000000111111111111111
        1000000100000000000001
        1000000100000000000001
        1000000100000000000001
111111111111011100000000000001
100000000000000000000111111111
10000000000000000000000000001
10000000000000000000000000001
11110111110000000000000000001
10000000000000000W00000000001
10000000010000010000011111111
10000000010000010000000000001111
10000000010000010000000000000001
11111111111111111111111111111111
