C 87,3,156
F 140,17,130

WE ./textures/portal.xpm
EA ./textures/ab.xpm
NO ./textures/flash.xpm
SO ./textures/uv.xpm


1111111111       11111
1000000001       10001111111111111111
1000000001       11011000000000000001111111111
1111011111       100010000000000000011100000011
   101           1000000000000000000110000000011
 11101111111     11111000000000000001000000000011
 10000000001         10000001010000010000000000011
 1000000000111111111111111111011111110000000000001
 1000000000000000000000000001010000000000000000001
 1000000000100000000000000W01010000000000000000011
 100000000010000000000000000101000000000000000011
 10000001111000000000111111110111110000000100001
 111110111 1100000000000000000000110000000100001
    11001111111111111111100000000111111100111111
    100000000000000000001000000000000000001
    111111111111100000000000000001111111111
                111111111111000001111110001
                           1110111000100001
                             101000000000001
                             10100000100001
                             10111111110001
                             10000000000011
                             11111111111111
