C 90,148,52
F 128,208,15

WE ./textures/mario_1.xpm
EA ./textures/mario_4.xpm
NO ./textures/mario_2.xpm
SO ./textures/mario_3.xpm

11111111111111111111111
100S0010000100010000111
11000000000000000000111
10000000011111000000011
10000000000000000001111
10000010000000000111111
11100011000100000000011
10000011000100000000001
11000001000100000000111
11000000010110000011111
11011000001110000000111
11111111111111111111111
